6 6 6 6 6 6 6 6 6 0 0 0 0 0 6 6 6 6 6 4 3 3 3 3 3 3 3 3 6 6 6 6 6 6 6 6 6 6 6 6 6 6 6 6 6 6 6 6 6 6 6 6 6 6 3 3 3 3 3 3 3 3 3 3
6 6 6 6 6 6 6 6 6 2 1 0 0 0 0 6 6 6 4 1 1 1 3 3 3 3 3 3 3 6 6 6 6 6 6 6 4 6 4 4 6 6 6 6 6 6 6 6 6 6 6 6 4 1 1 3 3 3 3 3 3 3 3 3
6 6 6 2 1 2 6 6 2 1 1 2 0 0 0 6 6 4 1 1 1 2 1 1 1 3 3 3 3 3 3 6 6 6 4 1 1 1 1 1 1 4 6 4 4 6 6 6 6 6 6 4 1 1 1 3 3 3 3 3 3 3 3 3
6 6 1 2 1 1 1 1 1 1 2 1 1 0 0 0 4 4 1 1 1 1 1 1 1 1 1 3 3 3 3 3 6 4 1 1 1 1 1 1 1 1 1 1 1 1 4 6 6 6 4 1 1 1 1 3 3 3 3 3 3 3 3 3
6 1 1 1 2 1 2 1 2 1 1 2 1 0 0 0 1 1 1 1 1 1 1 1 1 1 1 1 3 3 3 3 6 4 1 1 1 1 1 1 1 1 1 1 1 1 1 4 6 4 1 1 1 1 1 1 3 3 3 3 3 3 3 3
6 1 2 1 2 1 1 2 1 1 2 1 1 0 0 0 1 1 1 1 1 1 1 1 1 1 1 1 1 3 3 3 6 6 4 1 1 1 1 1 1 1 1 1 1 1 1 1 1 1 1 1 1 1 1 1 3 3 3 3 3 3 3 3
6 2 1 1 1 1 2 1 2 1 1 1 0 0 0 1 1 1 1 2 1 1 1 1 1 2 1 1 1 3 3 3 3 6 4 1 1 1 1 1 1 1 2 1 1 1 1 1 1 1 1 1 1 1 1 1 1 3 3 3 3 3 3 3
6 1 2 2 1 2 1 2 1 1 2 1 0 0 0 1 1 1 1 1 1 1 1 1 1 1 1 1 1 3 3 3 3 6 4 1 1 1 1 1 1 1 1 1 1 1 1 1 1 2 1 1 1 2 1 1 1 3 3 3 3 3 3 3
6 6 2 1 1 1 1 1 2 2 1 0 0 0 1 1 1 1 1 1 1 1 1 1 1 1 1 1 1 1 3 3 3 3 6 1 1 1 1 1 1 1 1 1 1 1 1 1 1 1 1 1 1 1 1 1 1 2 3 3 3 3 3 3
6 6 1 1 2 1 2 1 1 1 1 0 0 0 1 1 1 1 1 1 1 1 2 1 1 1 1 1 1 1 3 3 3 3 6 4 1 1 1 1 1 1 1 2 1 1 1 1 1 1 1 1 1 1 1 1 1 1 1 3 3 3 3 3
6 6 1 2 1 1 1 1 2 1 0 0 0 0 1 1 1 1 1 1 1 1 1 1 1 1 1 1 1 1 1 3 3 3 3 6 4 6 4 1 1 1 1 1 1 1 1 2 1 1 1 1 1 1 1 1 1 1 1 1 3 3 3 3
6 6 6 1 1 2 1 1 1 0 0 0 0 5 5 5 5 0 0 1 1 1 1 1 1 1 1 1 1 1 1 3 3 3 3 6 6 6 6 1 1 1 1 1 1 1 1 1 1 1 2 1 1 1 1 1 1 1 1 1 1 3 3 3
6 6 6 2 1 1 2 1 2 0 0 0 5 5 5 5 5 0 0 0 1 1 1 1 1 1 1 1 1 2 1 1 3 3 3 3 6 6 1 1 1 1 2 1 1 1 1 1 2 1 1 2 1 2 1 1 2 1 1 1 1 6 3 3
6 6 6 1 2 1 1 1 0 0 0 5 5 5 4 5 5 5 0 0 0 1 1 1 2 1 1 1 1 1 1 1 1 3 3 3 3 1 1 1 1 1 1 1 1 1 1 2 1 2 2 1 2 1 1 1 1 1 1 1 4 6 6 3
6 6 6 1 1 1 1 1 0 0 0 5 5 5 5 5 5 4 5 0 0 0 1 1 1 1 1 1 1 1 1 1 1 3 3 3 3 3 1 1 2 1 1 1 1 1 1 1 2 1 2 1 2 2 1 1 1 1 1 1 6 6 6 6
6 6 1 1 2 1 2 1 0 0 0 5 4 5 5 4 5 5 5 5 0 0 1 1 1 1 1 1 1 1 1 1 1 1 3 3 3 3 1 1 1 1 1 1 2 1 1 2 1 2 1 2 1 1 1 1 1 2 1 1 6 6 6 6
6 6 2 1 1 1 1 1 0 0 0 5 5 5 5 5 5 4 5 5 0 0 1 1 1 1 1 1 1 1 1 1 1 1 3 3 3 3 1 1 1 1 1 1 1 1 1 1 2 1 2 1 2 2 1 1 1 1 1 4 6 6 6 6
6 6 1 1 1 1 1 1 1 0 0 0 5 5 4 5 5 5 5 5 0 0 1 1 1 1 1 1 1 1 2 1 1 1 1 3 3 3 3 1 1 1 1 1 1 1 1 1 1 2 1 2 1 1 1 1 1 1 1 6 6 6 6 6
6 1 1 1 1 1 1 1 1 0 0 0 0 5 5 5 5 5 5 0 0 0 1 1 1 1 2 1 1 1 1 1 1 1 1 3 3 3 3 1 1 2 1 1 1 1 2 1 1 1 1 1 1 1 1 1 1 1 1 6 6 6 6 6
6 1 1 1 1 1 1 1 1 1 0 0 0 0 5 5 5 5 0 0 0 1 1 1 1 1 1 1 1 1 1 1 1 1 1 1 3 3 3 3 1 1 1 1 1 1 1 1 1 1 1 1 1 1 1 1 2 1 1 6 6 6 6 6
3 1 1 1 1 1 1 1 1 1 1 0 0 0 0 0 0 0 0 0 0 1 1 1 1 1 1 1 1 1 1 1 1 1 1 1 3 3 3 3 1 1 1 1 1 1 1 1 1 1 1 2 1 1 1 1 1 1 1 1 6 6 6 6
3 3 1 1 1 1 1 1 1 1 1 1 0 0 0 0 0 0 0 1 1 1 1 1 1 1 1 1 1 1 1 1 2 1 1 1 3 3 3 3 3 1 1 1 1 1 1 1 1 1 1 1 1 1 1 1 1 1 1 1 4 6 6 6
3 3 3 1 1 1 2 1 1 1 1 1 1 1 1 1 1 1 1 1 1 1 1 1 1 1 1 1 1 1 1 1 1 1 1 1 1 3 3 3 3 1 1 1 1 1 1 1 1 1 1 1 1 1 1 1 1 1 1 1 1 6 6 6
3 3 3 3 1 1 1 1 1 1 1 1 1 1 1 1 1 1 1 1 1 1 1 1 1 1 1 2 1 1 1 1 1 1 1 1 1 3 3 3 3 1 1 1 1 2 1 1 1 1 1 1 1 1 2 1 1 1 1 2 1 6 6 6
3 3 3 3 3 1 1 1 1 1 1 1 1 1 1 1 1 1 1 1 1 1 1 1 1 1 1 1 1 1 1 1 1 1 1 1 1 1 3 3 3 3 1 1 1 1 1 1 1 2 1 1 1 1 1 1 1 1 1 1 1 1 6 6
3 3 3 3 3 3 1 1 1 1 1 1 1 1 1 1 1 1 2 1 1 1 1 1 1 1 1 1 1 1 1 1 1 2 1 1 1 1 3 3 3 3 1 1 1 1 1 1 1 1 1 1 1 1 1 1 1 1 1 1 1 1 4 6
3 3 3 3 3 3 1 1 1 1 1 1 1 1 1 1 2 1 1 1 1 1 1 2 1 1 1 2 1 1 2 1 1 1 1 1 1 1 3 3 3 3 1 1 1 1 1 1 1 1 1 1 1 1 1 1 1 1 1 1 1 6 6 6
3 3 3 3 3 3 1 1 1 1 2 1 1 1 1 1 1 1 1 1 1 1 1 1 1 1 1 1 1 1 1 1 1 1 1 1 1 1 1 3 3 3 1 1 2 1 1 1 1 1 1 1 1 1 1 2 1 1 1 2 1 6 6 6
3 3 3 3 3 3 1 2 1 1 1 1 1 1 2 1 1 1 1 2 1 1 1 1 1 2 1 1 1 2 1 1 1 2 1 1 1 1 1 3 3 3 1 1 1 1 1 2 1 1 2 1 1 2 1 1 1 1 1 1 1 4 6 6
3 3 3 3 3 3 3 1 1 2 1 1 2 1 1 1 1 2 1 1 1 1 2 1 1 1 1 2 1 1 1 2 1 1 1 1 2 1 1 3 3 3 1 1 1 2 1 1 1 1 1 1 1 1 1 1 1 2 1 1 1 1 6 6
3 3 3 3 3 3 3 1 1 1 1 1 1 1 1 2 1 1 1 1 1 1 1 1 2 1 1 1 1 1 1 1 1 1 1 1 1 1 1 3 3 3 3 1 1 1 1 1 2 1 1 1 1 2 1 1 1 1 1 1 1 1 4 6
3 3 3 3 3 3 3 5 5 5 5 5 5 5 5 5 5 5 5 5 5 5 5 5 5 5 5 5 5 5 5 5 5 5 5 5 5 5 5 3 3 3 3 5 5 5 5 5 5 5 5 5 5 5 5 5 5 5 5 5 5 5 6 6
3 3 3 3 3 3 3 5 5 5 5 5 5 5 5 5 5 5 5 5 5 5 5 5 5 5 5 5 5 5 5 5 5 5 5 5 5 5 5 5 3 3 3 5 5 5 5 5 5 5 5 5 5 5 5 5 5 5 5 5 5 5 5 6
3 3 3 3 3 3 3 1 2 1 1 1 2 1 1 1 1 1 1 1 1 1 1 1 1 1 1 1 2 1 1 1 1 1 1 1 1 1 1 1 3 3 3 3 1 1 1 1 1 1 1 1 1 1 1 1 1 1 1 1 1 1 1 0
3 3 3 3 3 3 3 1 1 1 1 1 1 1 1 1 2 1 1 1 1 2 1 1 1 2 1 1 1 1 1 2 1 1 1 1 1 1 1 1 3 3 3 3 1 1 1 1 1 1 1 2 1 1 1 1 1 1 1 1 1 1 0 0
3 3 3 3 3 3 1 1 1 1 2 1 1 1 1 1 1 1 1 2 1 1 1 1 1 1 1 1 1 1 1 1 1 1 1 2 1 1 2 1 1 3 3 3 1 1 1 1 2 1 1 1 1 1 1 1 1 2 1 1 1 0 0 0
3 3 3 3 3 3 1 1 1 1 1 1 1 1 1 1 1 1 1 1 1 1 1 1 1 1 1 1 1 1 1 1 2 1 1 1 1 1 1 1 1 1 1 1 1 1 1 1 1 1 1 1 1 2 1 1 1 1 1 2 0 0 0 0
3 3 3 3 3 2 1 1 1 1 1 1 1 1 2 1 1 1 1 1 1 1 1 1 1 1 1 2 1 2 1 1 1 1 1 1 1 1 1 1 1 1 1 1 1 2 1 1 1 1 1 1 1 1 1 1 1 1 1 1 0 0 0 0
3 3 3 3 3 1 1 1 1 1 1 1 1 1 1 1 1 1 1 1 1 1 1 2 1 1 1 1 1 1 1 1 1 1 1 1 1 2 1 1 1 1 1 1 1 1 1 1 1 1 2 1 1 1 1 2 1 1 1 1 0 0 0 0
3 3 3 3 3 1 1 1 1 1 1 1 1 1 1 1 1 1 1 1 1 1 1 1 1 1 1 1 1 1 1 1 1 2 1 1 1 1 1 1 3 3 3 3 1 1 1 2 1 1 1 1 1 1 1 1 1 2 1 1 0 0 0 0
3 3 3 3 1 1 1 1 1 1 2 1 1 1 1 1 1 2 1 1 1 1 1 1 1 1 1 1 1 1 1 1 1 1 1 1 1 1 1 3 3 3 3 1 1 1 1 1 1 1 1 1 1 1 1 1 1 1 1 1 0 0 0 0
3 3 3 3 1 1 1 1 1 1 1 1 1 1 1 1 1 1 1 1 1 1 1 1 1 1 1 1 1 1 1 1 1 1 1 2 1 1 1 3 3 3 3 1 1 1 1 1 1 1 1 1 1 2 1 1 1 1 1 1 1 0 0 0
3 3 3 3 1 1 1 1 1 1 1 1 1 1 1 1 1 1 1 1 1 1 1 1 1 1 1 1 2 1 1 1 1 1 1 1 1 3 3 3 3 3 1 1 1 1 1 1 1 1 1 2 1 1 1 1 1 1 2 1 1 0 0 0
3 3 3 1 2 1 1 1 1 1 1 1 1 1 1 1 1 1 1 1 1 1 1 2 1 1 1 1 1 1 1 1 1 1 1 1 3 3 3 3 3 1 1 1 1 1 1 2 1 1 1 1 1 1 1 1 1 1 1 1 1 0 0 0
3 3 3 1 1 1 1 1 1 2 1 1 1 1 1 1 1 1 1 1 1 1 1 1 1 1 1 1 1 1 1 2 1 1 1 3 3 3 3 3 1 1 1 1 1 1 1 1 1 1 1 1 1 1 1 2 1 1 1 1 1 0 0 0
3 3 1 1 1 1 1 1 1 1 1 1 1 1 1 1 1 1 2 1 1 1 1 1 1 1 1 1 1 1 1 1 1 1 3 3 3 3 3 1 1 1 1 2 1 1 1 1 1 2 1 1 1 1 1 1 1 2 1 1 1 1 0 0
3 3 1 1 1 1 1 1 1 1 1 1 1 1 1 1 1 1 1 1 1 1 1 1 1 1 1 1 1 1 1 1 1 3 3 3 3 3 1 1 1 1 1 1 1 1 2 1 1 1 1 1 1 1 1 1 1 1 1 1 1 1 0 0
3 3 1 1 1 1 1 1 1 1 1 1 1 5 1 1 1 1 1 1 1 1 1 1 1 1 1 1 1 1 1 1 3 3 3 3 3 1 1 1 1 1 1 1 1 1 1 1 1 1 1 2 1 1 2 1 1 1 1 1 1 2 0 0
3 3 1 1 1 1 1 1 1 1 1 1 5 5 5 1 1 1 1 1 1 1 2 1 1 1 1 2 1 1 3 3 3 3 3 3 1 1 1 2 1 1 1 1 1 1 1 1 1 1 1 1 1 1 1 1 1 1 1 1 1 0 0 0
3 1 1 1 1 1 1 1 1 1 1 5 5 5 5 5 1 1 1 1 1 1 1 1 1 1 1 1 1 3 3 3 3 3 3 1 1 1 1 1 1 1 1 2 1 1 1 2 1 1 1 1 1 1 1 1 1 2 1 1 1 0 0 0
6 1 1 1 1 1 1 2 1 1 1 1 5 5 5 1 1 1 1 1 1 1 1 1 1 1 1 1 3 3 3 3 3 1 1 1 1 1 1 1 1 1 1 1 1 1 1 1 1 1 1 1 1 1 1 1 1 1 1 1 1 0 0 0
6 6 1 2 1 1 1 1 1 1 1 1 1 5 1 1 1 1 1 1 1 1 1 1 1 1 1 3 3 3 3 3 6 1 1 1 1 1 1 1 1 1 1 1 1 1 1 1 1 1 1 1 2 1 1 2 1 1 1 1 0 0 0 0
6 4 1 1 1 1 1 1 1 1 1 1 1 1 1 1 1 1 1 1 1 1 1 1 1 1 3 3 3 3 3 6 6 6 6 1 1 2 1 1 2 1 1 1 2 1 1 1 1 1 1 1 1 1 1 1 1 1 1 1 0 0 0 0
6 6 6 1 1 1 1 1 1 1 1 1 1 1 1 1 1 1 1 1 2 1 1 1 1 1 3 3 3 3 6 6 6 6 6 1 1 1 1 1 1 1 1 1 1 1 1 1 1 2 1 1 1 1 1 1 1 2 1 1 0 0 0 0
6 6 6 1 1 1 1 1 1 1 1 1 1 1 1 1 1 1 1 1 1 1 1 1 1 3 3 3 3 6 6 6 6 4 2 1 1 1 1 1 1 1 1 1 1 1 1 1 1 1 1 1 1 1 1 1 1 1 1 1 0 0 0 0
6 6 1 1 1 1 1 1 1 1 1 1 1 2 1 1 1 1 1 1 1 1 1 1 1 3 3 3 3 6 6 6 1 1 1 1 1 1 1 1 1 1 2 1 1 1 1 1 1 1 1 1 1 2 1 1 1 1 1 1 0 0 0 0
6 6 1 1 1 1 1 2 1 1 1 1 1 1 1 1 1 1 1 1 1 1 1 1 1 3 3 3 6 6 6 4 1 1 1 2 1 1 1 2 1 1 1 1 1 2 1 1 1 1 1 1 1 1 1 1 2 1 1 1 0 0 0 0
6 6 4 1 1 1 1 1 1 1 1 1 1 1 1 1 1 1 1 1 1 1 1 1 3 3 3 3 6 6 6 1 1 1 1 1 1 1 1 1 1 1 1 1 1 1 1 1 1 2 1 1 1 1 1 1 1 1 1 1 0 0 0 0
6 6 6 1 1 1 1 1 1 1 1 1 1 1 1 1 2 1 1 1 1 1 2 1 3 3 3 6 6 6 4 1 1 1 1 1 1 1 2 1 1 1 2 1 1 1 1 1 1 1 1 1 1 1 1 1 1 1 1 1 1 0 0 0
6 6 6 4 1 1 1 1 1 1 1 1 1 1 1 1 1 1 1 1 1 1 1 1 3 3 3 6 6 6 2 1 2 1 1 1 1 1 1 1 1 1 1 1 2 1 1 1 1 1 1 1 1 1 2 1 1 1 1 2 1 0 0 0
6 6 6 6 4 1 1 1 1 1 1 1 6 6 1 1 1 1 1 1 1 3 3 3 3 3 3 6 4 1 1 1 1 1 1 2 1 1 6 6 4 1 1 1 1 1 1 1 1 2 1 1 1 1 1 1 1 1 1 1 0 0 0 0
6 6 6 6 6 4 6 4 1 1 6 4 6 4 1 1 1 1 1 3 3 3 3 3 3 3 3 6 6 1 2 1 1 1 1 1 1 4 6 6 6 6 4 1 1 1 2 1 1 0 0 0 0 0 0 0 1 2 1 0 0 0 0 0
6 6 6 6 6 6 6 6 6 6 6 6 6 6 6 1 1 1 3 3 3 3 3 3 3 3 3 3 6 6 1 1 1 1 1 4 6 6 6 6 6 6 6 6 1 1 1 0 0 0 0 0 0 0 0 0 0 0 0 0 0 0 0 0
6 6 6 6 6 6 6 6 6 6 6 6 6 6 6 6 3 3 3 3 3 3 3 3 3 3 3 3 3 6 4 6 6 4 6 6 6 6 6 6 6 6 6 6 6 0 0 0 0 0 0 0 0 0 0 0 0 0 0 0 0 0 0 0
